18 14
9 7
8 8 8 9 9 9 9 9 9 9 9 9 9 9 9 9 8 8
8 8 9 7 7 7 5 5 7 7 5 5 7 7 7 9 8 8
8 9 7 7 9 9 9 9 9 9 9 9 9 9 7 7 9 8
9 5 5 9 6 6 6 1 1 1 6 6 6 6 9 5 5 9
9 5 5 9 6 6 6 1 3 1 6 6 6 6 9 5 5 9
9 7 7 9 6 6 6 1 0 1 1 1 1 6 9 7 7 9
9 7 7 9 6 1 1 1 2 0 2 3 1 6 9 7 7 9
9 7 7 9 6 1 3 0 2 0 1 1 1 6 9 7 7 9
9 7 7 9 6 1 1 1 1 2 1 6 6 6 9 7 7 9
9 5 5 9 6 6 6 6 1 3 1 6 6 6 9 5 5 9
9 5 5 9 6 6 6 6 1 1 1 6 6 6 9 5 5 9
8 9 7 7 9 9 9 9 9 9 9 9 9 9 7 7 9 8
8 8 9 7 7 7 5 5 7 7 5 5 7 7 7 9 8 8
8 8 8 9 9 9 9 9 9 9 9 9 9 9 9 8 8 8