18 15
6 6
8 8 8 9 9 9 9 9 9 9 9 9 9 9 9 9 8 8
8 8 9 7 7 7 5 5 7 7 5 5 7 7 7 9 8 8
8 9 7 7 9 9 9 9 9 9 9 9 9 9 7 7 9 8
9 5 5 9 6 1 1 1 1 1 1 1 1 6 9 5 5 9
9 5 5 9 6 1 0 0 1 0 0 0 1 6 9 5 5 9
9 7 7 9 6 1 0 2 3 3 2 0 1 6 9 7 7 9
9 5 5 9 6 1 0 2 3 4 0 1 1 6 9 5 5 9
9 5 5 9 6 1 0 2 3 3 2 0 1 6 9 5 5 9
9 7 7 9 6 1 0 0 1 2 2 0 1 6 9 7 7 9
9 5 5 9 6 1 0 0 1 0 0 0 1 6 9 5 5 9
9 5 5 9 6 1 0 0 0 0 0 0 1 6 9 5 5 9
9 7 7 9 6 1 1 1 1 1 1 1 1 6 9 7 7 9
8 9 7 7 9 9 9 9 9 9 9 9 9 9 7 7 9 8
8 8 9 7 7 7 5 5 7 7 5 5 7 7 7 9 8 8
8 8 8 9 9 9 9 9 9 9 9 9 9 9 9 8 8 8
